Coronavirus: Donald Trump wears face mask for the first time	The US president previously said he could not see himself wearing a mask in public.
Daniel Lewis Lee: First US federal execution to go ahead after 17 years	The execution of convicted murderer Daniel Lewis Lee had been blocked on Friday by a federal judge.
Roger Stone: Robert Mueller defends indictment over Russia probe	Ex-US special counsel Robert Mueller intervenes after President Trump commutes an aide's jail term.
Walt Disney World reopens in Florida amid Covid-19 surge	Visitors are required to wear masks, socially distance and have temperature checks on arrival.
Goya Foods: Hispanic brand faces boycott for praising Trump	Democrats including Alexandria Ocasio-Cortez have urged customers to stop buying Goya Foods products.
Jada Pinkett Smith tells Will Smith of her 'relationship'	Jada Pinkett Smith and Will Smith were talking on her Facebook chat show Red Table Talk.
TikTok: Amazon says email asking staff to remove app 'sent in error'	Earlier, the company had asked staff to remove the TikTok app from phones over "security risks."
Ghislaine Maxwell requests bail due to 'significant' coronavirus risk	The British socialite denies grooming underage girls for the late paedophile Jeffrey Epstein.
Three generations on the impact of George Floyd's death	Three generations of one family discuss their experiences of racism and whether things are changing.
This police-free protest zone was dismantled - but was it the end?	On 8 June protesters set up a police-free protest zone in the city. Less than a month later, it had been dismantled.
Coronavirus: The chaplains toiling on the frontlines	Spiritual care workers have been thrust onto the frontlines in new ways during this global pandemic.
Coronavirus: How bad is the crisis in US care homes?	America's elderly are dying at an alarming rate in care homes, but the picture remains incomplete.
What are the questions for Ghislaine Maxwell?	The arrest of Jeffrey Epstein's former girlfriend has reignited interest in her and her alleged role in Epstein's abuse of minors.
Trump and Supreme Court: How has it changed America?	This court has been billed the most conservative in modern history. But does it vote that way?
Black Lives Matter: From social media post to global movement	Black Lives Matter has sparked a hashtag, grass-roots organisations, and a collective of activists.
US student visas: 'A lot of people I know are scared for the future'	The US said some visas could be revoked because of coronavirus, leaving students confused and uncertain.
Cancel culture: What unites young people against Obama and Trump	The push to bring down memorials has renewed criticisms of "cancel culture" from current and past presidents.
Kanye West: Presidential hopeful wants to run the White House like Wakanda	The rapper and presidential hopeful wants to run the White House like Wakanda.
Coronavirus: Disease detectives track an invisible culprit	They're working frantically to stop the pandemic spreading. And sometimes that means some awkward conversations.
Viewpoint: What Donald Trump gets wrong about Somalia	Somalia has been caught up in the US election campaign thanks to Donald Trump, writes Ismail Einashe.
'I left her as a baby - 16 years later she saved my life'	When Matjames Metson hit rock bottom after Hurricane Katrina, it was the daughter he hadn't seen for 16 years who turned his life around.
Coronavirus: What makes a gathering a â€˜superspreaderâ€™ event?	How can a two-hour choir practice lead to 53 Covid-19 infections? We ask an expert.
Coronavirus: What's behind alarming new US outbreaks?	Cases are rising in Texas, Florida, Arizona and California - here's a look at the data and the theories.
Trump, Russia and the Taliban: The story in 300 words	It's a complicated story about bounties and back channels. Let's break it down.
The American pioneer who could not change Nascar	Wendell Scott was a pioneering Nascar driver whose legacy has touched only the fringes of a sport now seeking transformation.
Being black in business is being 'on your own'	The coronavirus pandemic is expected to widen America's longstanding economic disparities.
Coronavirus: How coming-of-age rituals were interrupted - and reinvented	How coming-of-age rituals were interrupted - and reinvented - amid the coronavirus pandemic.
Black America Speaks: What black radio makes of this moment	"Hunted" because of my race: The BBC tunes in to black-owned radio stations amid national upheaval.
Black Lives Matter: Can viral videos stop police brutality?	Do viral videos like the one captured of George Floyd's death actually reduce police abuse?
George Floyd death: What US police officers think of protests	Some think change needs to come from the top, others say they are doing a tough job and under attack.
Young skater goes viral performing at Black Lives Matter Plaza	A video of Kaitlyn Saunders skating on the square opposite the White House has amassed 5 million views.
'Speak and be heard': Why black media matters	Sara Lomax-Reese owns WURD, one of a handful of black-owned and operated radio stations in the US.
'My best friend was killed in the protests - I'm marching for him'	19-year-old Diamond wants "justice" for her friend, who died days after George Floyd.
One thing Americans find hard to talk about	A US psychologist who specialises in conflict resolution overseas is now turning her attention to race at home.
George Floyd death: 'The same happened to my son'	An immigrant community divided by the anti-racist protests rocking the US.
Atatiana Jefferson: 'Why I will no longer call the police'	When James Smith called police to check his neighbour was OK, she ended up dead. Never again, he says.
Coronavirus: What attacks on Asians reveal about American identity	Covid-inspired attacks on East Asian people in the US reveal uncomfortable truths about American identity.
Viewpoint: US must confront its Original Sin to move forward	Neglect of the past and belief in progress has left many unaware of the scope of US racial tensions.
Viewpoint: Why racism in US is worse than in Europe	Writer Barrett Holmes Pitner explains why he thinks American racism is unique.
Eric Garner death inspires an unlikely police experiment	What happened when officers and civilians watched a video of a man dying at the hands of the police?
How America moves beyond its racist past	The BBC's Aleem Maqbool examines ways the US can move beyond it's racist history.
Driving into the art of Vincent Van Gogh	Toronto's immersive exhibition allows audiences to experience art from the comfort of their car.
Coronavirus: Protest, rally or eating out - Where is riskier?	Dr Georges Benjamin breaks down the risks of going into crowds and how best to protect yourself.
Why Texas is seeing a surge in coronavirus cases	In the past week, the state has seen upwards of 6,000 new cases every day and hospitals are reaching capacity.
Martin Luther King Jr's daughter: 'I know the pain of growing up without a father'	Rev Bernice A King was speaking at Rayshard Brooks' funeral in Atlanta, Georgia.
Living through the threat of eviction in the pandemic	The BBC meets a single father of three as he navigates trying to keep his apartment.
Trump voter: 'These people here are genuine Americans'	The BBC went to the US state of Montana to hear what voters think of President Trump.
Early American policing - runaway slave patrols	From slave patrols to enabling lynchings, we look at the history of police violence in black America.
'This has to be a fundamental rethinking' of police tactics	Governor Cuomo says that little has changed since Rodney King was a victim of police brutality in 1991.
White House likens Trump to Churchill in WW2	The press secretary compares the president to the British wartime leader inspecting bomb damage.
Barack Obama: I want you to know that you matter	The ex-US president has been giving his first video address since unrest over the death of George Floyd.
'We felt like we were going to die in that car'	Two black students were dragged from their car in Atlanta, Georgia, by police, who now face charges.
George Floyd's daughter, 6, is 'proof he was good'	Roxie Washington, mother of Gianna, six, broke down in tears at a press conference in Minneapolis.
George Floyd protests: Trudeau's epic pause when asked about Trump's response	Asked about race, unrest and the US response, the Canadian prime minister chose his words carefully.
Derek Chauvin is charged with second-degree murder	Minnesota Attorney General Keith Ellison upgraded charges for officers involved in George Floyd case.
