Coronavirus: US records highest death toll in single day	More than 1,736 deaths were recorded on Tuesday with some states yet to share their totals.
Coronavirus: Wisconsin defies its own lockdown to vote	Wisconsin is the first state to hold a major election despite a state-wide stay home order.
Coronavirus: Twitter boss pledges $1bn for relief effort	Jack Dorsey said he would give 28% of his wealth towards efforts to "disarm" the pandemic.
Coronavirus warship row: Acting US Navy secretary resigns	The acting Navy chief was under fire for ousting a captain who pleaded for help fighting Covid-19.
Coronavirus: Why more rats are being spotted during quarantine	Hungry rats unable to feed off restaurant leftovers are coming on to the streets and nearer homes.
Maeve Kennedy McKean's body is recovered after canoe search	Maeve Kennedy McKean and her son were last seen in a canoe off Chesapeake Bay in Maryland last week.
Coronavirus wreaks havoc in African American neighbourhoods	Black Chicagoans account for 70% of coronavirus deaths, despite making up 30% of the population.
Coronavirus: With Wrestlemania, the show must go on no matter what	The biggest event in wrestling went ahead at the weekend, undaunted by all mainstream sport being cancelled.
How the coronavirus led to the highest-ever spike in US gun sales	More than 2m guns were purchased in March and the FBI conducted 3.7m background checks.
Coronavirus: Helping frontline medics with a place to stay	Doctors and nurses treating coronavirus patients have to self-isolate away from family between shifts.
Coronavirus: Why healthcare workers are at risk of moral injury	War veterans can experience trauma known as moral injury - now health workers are at risk too.
Coronavirus: 'Pregnancy during a pandemic is terrifying'	Carly was already a high-risk pregnancy. Now, she fears the toll of Covid-19 on hospitals could put her more at risk.
Coronavirus: Pastor who decried 'hysteria' dies after attending Mardi Gras	A preacher who said coronavirus was overhyped has died after catching the virus at Mardi Gras.
Coronavirus: US tourist towns telling visitors to stay away	Its state slogan is "live free or die" - but locals now fear being overwhelmed by tourists.
How Trump's attitude toward coronavirus has shifted	Since the start of the year, how has President Trump's attitude towards coronavirus changed?
Coronavirus: The US governor who saw it coming early	Ohio's Mike DeWine began preparing for the virus before a single case was reported in his state.
Coronavirus: US death rates v China, Italy and South Korea	The US has seen its virus cases spike dramatically and these graphs show what could be in store.
Coronavirus: A snapshot of American life under lockdown	How much your life has changed because of the coronavirus depends a lot on where in the US you live.
Coronavirus: Why China's claims of success raise eyebrows	China has claimed its first day without a virus death, but faces lingering scepticism over its data.
Coronavirus: Why has Turkmenistan reported no cases?	While many countries have imposed major restrictions, life continues as normal in Turkmenistan.
Coronavirus: Why Canada dairy farmers are dumping milk	A dairy farmer's association has instructed farmers to dump milk over fear of a price crash.
How sex workers are starting again online	Increased competition and privacy risks are some of the challenges facing workers making the switch.
YouTube tightens Covid-19 rules over 5G conspiracies	Videos will now be deleted if they falsely link coronavirus to 5G mobile networks.
Coronavirus and chloroquine: Is there evidence it works?	Some world leaders are keen on chloroquine anti-malarial drugs to treat Covid-19 - what's the evidence?
Coronavirus: Israelâ€™s ultra-Orthodox lockdown challenge	Coronavirus has hit Israelâ€™s ultra-Orthodox Jews disproportionately, but implementing lockdown in those communities has been challenging.
Pixar pioneers behind Toy Story animation win 'Nobel Prize' of computing	The men who made Toy Story and Finding Nemo possible speak to the BBC about their Turing Award win.
Madam CJ Walker: 'An inspiration to us all'	How an African-American orphan and single mother founded a business empire - 114 years ago.
Introducing the soaring melodies of Azure Ryder	How one of popâ€™s brightest new voices found confidence by taking control of a plane.
How the Cornish pasty came to prosper in Virginia	Some of the world's best pasties can be found across the pond in the US state of Virginia.
Why Anne Tyler won't be writing about the coronavirus	One of America's greatest living writers says it would be "wrongheaded" to mention the virus in a book.
Coronavirus: The good that can come out of an upside-down world	There are reasons to believe the world may emerge from this upheaval enhanced, writes Matthew Syed.
Coronavirus: A college course world wants to study right now	More than one million people have enrolled in a Yale course on well-being. So what's its secret?
The Village People's YMCA is preserved for posterity	The disco hit is deemed historically important enough to enter the US National Recording Registry.
'I bought a winery and it caused a US-French row'	When US entrepreneur Michael Baum bought a famous French vineyard it caused a trans-Atlantic spat.
Coronavirus: Words at the window from those in isolation	Portraits of families self-isolating in Brooklyn to slow the spread of the coronavirus.
How Marsha Hunt fought Hollywood blacklisting	The 102-year-old is one of the last people still alive who was named as a communist sympathiser.
Does pandemic offer US and Iran chance for partial reset?	Jonathan Marcus looks at whether the crisis might lead to some rapprochement between the arch-foes.
Why Texas is saying 'no' to all new refugees	Texas' longstanding reputation for hospitality has taken a hit as it embraces a new Trump refugee plan.
Minecraft â€˜loopholeâ€™ library of banned journalism	How the popular video game Minecraft is being used as a way for journalism to beat global censors.
Harvey Weinstein: How a Hollywood giant faced his reckoning	The judge said this was not a referendum on #MeToo. But at times, his trial felt like one.
Harry and Meghan's final royal duties before 'stepping back'	The couple are completing their last engagements before stepping back as working royals from 31 March.
