Trump Attacks W.H.O. and Ousts Watchdog for Pandemic Fund	New York and New Jersey recorded one-day highs for deaths, and voters in Wisconsin cast ballots while trying to exercise proper social distancing.
Wuhan, Where Coronavirus Emerged, Lifts Lockdown After 11 Weeks: Live Coverage	Prime Minister Boris Johnson spent a second night in intensive care, and President Trump threatened to cut funding for the World Health Organization.
N.Y. Virus Deaths Hit New High, but Hospitalizations Slow	New Jersey and Connecticut also had one-day highs in coronavirus-related deaths. Officials in the three states still saw reason for hope.
Their Grandmother Left by Ambulance. Then They Could Not Find Her.	â€œI believe she passed away,â€ said a relative who led the familyâ€™s increasingly frantic search. â€œBut where?â€
New Battle for Those on Coronavirus Front Lines: Child Custody	Doctors, firefighters and others who risk exposure to Covid-19 are being taken to court by ex-spouses who want to keep them away from their children.
Free Access to Coronavirus Coverage	The Times is providing free access on the coronavirus crisis. Start here for a guide to all our coverage.
Black Americans Face Alarming Rates of Coronavirus Infection in Some States	Data on race and the coronavirus is too limited to draw sweeping conclusions, experts say, but disparate rates of sickness â€” and death â€” have emerged in some places.
With Demand Soaring, Congress Weighs Adding $250 Billion in Small-Business Aid	Less than two weeks after enactment of a $2 trillion stimulus plan, the Trump administration is asking for a fresh infusion of funds to help businesses survive the economic damage of the coronavirus.
Small Business Aid Program Stretches Agency to Its Limits	The Small Business Administration is not equipped to handle the demand for emergency loans. It is trying to fix aging systems, but the delays are rattling banks and small businesses.
Voting in Wisconsin During a Pandemic: Lines, Masks and Plenty of Fear	Wisconsinâ€™s primary showed an electoral system stretched to the breaking point by the coronavirus crisis, as people weighed the health risks against their desire to vote.
What if the Most Important Election of Our Lifetimes Was the Last One?	Wisconsin voters may have risked their health to make it to the polls in a pandemic. But lately, itâ€™s feeling as though 2016, not 2020, remains the most pivotal political moment.
Why Wisconsin Republicans Insisted on an Election in a Pandemic	Mask-wearing voters in endless lines. Five polling places instead of 180. Voting amid the coronavirus crisis is full of challenges â€” and connected to G.O.P. efforts to limit who gets a ballot in the state.
China Ends Wuhan Coronavirus Lockdown, but Normal Life is a Distant Dream	In the city where the coronavirus outbreak was first reported, the reopening of outbound travel wonâ€™t end hard times, wariness or confinement.
Japan Declared a Coronavirus Emergency. Is It Too Late?	Some medical experts said the move amounted to a tacit admission that the approach the country had adopted for months was no longer working.
China Investigates Ren Zhiqiang, Critic of Xiâ€™s Coronavirus Response	The decision to investigate the tycoon, Ren Zhiqiang, reflects broad unease in the government about growing criticism of its early efforts to conceal the outbreak.
John Prine, Who Chronicled the Human Condition in Song, Dies at 73	A folk singer and songwriter with a raspy voice and an offbeat humor, he was revered by his peers, including Bob Dylan.
Albert Petrocelli, Fire Chief Who Lost a Son on 9/11, Dies at 73	He and a firefighter son answered the call when terrorists attacked the World Trade Center; another son died there. Mr. Petrocelli had the novel coronavirus.
Those Weâ€™ve Lost to the Coronavirus	This series tells the stories of people who have died in the pandemic.
â€˜I Just Need the Comfortâ€™: Processed Foods Make a Pandemic Comeback	Shoppers, moved by nostalgia and hunting for longer shelf lives, are returning to old standbys like Chef Boyardee and Campbellâ€™s soup.
How the Four Seasons in N.Y.C. Became a Dorm for Hospital Workers	The Four Seasons reinvented itself in a matter of days.
Coronavirus, Wisconsin, Pandas: Your Tuesday Evening Briefing	Hereâ€™s what you need to know at the end of the day.
Wisconsinâ€™s Pandemic Primary	Voters are facing a choice even before they see the ballot: whether to protect their health, or to exercise their civic duty.
Passover Goes On, With Screens	Religious families lean on technology this month to recreate disrupted rituals.
Delicious Vinyl	We examine when culture from our past â€” like the 20-year-old comedy â€œHigh Fidelityâ€ â€” gets reborn â€¦ as â€œHigh Fidelity.â€
Drop the Curtain on the Trump Follies	Why does the nation need to be subjected to the presidentâ€™s daily carnival of misinformation, preening and political venom?
Privacy Cannot Be a Casualty of the Coronavirus	Many Americans now rely on digital tools to work remotely and stay connected. They shouldnâ€™t have to sacrifice their privacy to use them.
The Pandemicâ€™s Missing Data	We desperately need to release the statistics on race and ethnicity.
For Coronavirus, Trump Is Not the Wartime President We Need	He should start leading with the decency and resolve that we deserve. Iâ€™m not holding my breath.
Bubby Locked Her Memories Away. One Passover Released Them.	â€˜I remember my father, before the war, hanging a matzo on the wall,â€™ my wifeâ€™s grandmother murmured, entranced. Suddenly, there sat a young Polish child.
What America Needs Next: A Biden National Unity Cabinet	We need a political system that mirrors the best in us.
Italy Is Sending Another Warning	This is what a country a month into lockdown looks like: desperate, hungry and scared.
Boris Johnson vs. the Coronavirus	With the prime minister of Britain in intensive care, Covid-19 has created a vacuum.
In the Coronavirus Crisis, There Are No Experts	In a pandemic, itâ€™s not just truth against misinformation. Every choice is an experiment.
Coronavirus Shows That We Have a Solidarity Problem	Itâ€™s a lot harder to join together when youâ€™re not allowed within six feet of each other.
I Hope My Neighbor Plays BeyoncÃ© Tonight	In coronavirus quarantine, the music coming through the thin walls is keeping me sane.
Meet Your Meme Lords	A small team at the Library of Congress is archiving internet culture as fast as it can (now, from home).
Itâ€™s a TikTok! No, Itâ€™s a Song! Drake and the Viral Feedback Loop	â€œToosie Slideâ€ is one of a few new hip-hop songs that werenâ€™t songs first â€”Â they were ideas spreading on social media.
Our Best Passover Recipes	Here are all of the recipes you need for your Passover feast.
USNS Comfort Crew Member Tests Positive for Coronavirus	The news was the latest setback in the shipâ€™s troubled mission to New York.
U.F.C. 249, Skirting Coronavirus Limits, Is Set for Tribal Land in California	The move for a card that includes a highly anticipated fight involving Tony Ferguson is an end run around state regulators and nationwide public health guidelines.
Jack Dorsey Vows to Donate $1 Billion to Fight the Coronavirus	The founder of Twitter and Square said he was putting nearly a third of his total wealth toward the effort.
Who Is Kayleigh McEnany? President Trump's New Press Secretary	Kayleigh McEnany, his campaign spokeswoman, replaces Stephanie Grisham, who had the job for nine months, and will return to Melania Trumpâ€™s staff.
Tennesee Pilot Stabbing: 3 Killed and 1 Wounded at Truck Stop	The suspect, Idris Abdus-Salaam, 33, of Durham, N.C., was shot and killed by a law enforcement officer, the authorities said.
Seasonal Bars and Food Festivals Feel Pandemicâ€™s Effects	Warm-weather food businesses are putting their plans, and many of their workers, on hold.
Rulings on Wisconsin Election Raise Questions About Judicial Partisanship	Some legal scholars said the decisions by the state and U.S. supreme courts could undermine confidence in the rule of law. Others said they were the product of judicial philosophy, not partisanship.
With Games Paused, Sports Companies Shift to Making Medical Supplies	Formula One teams are producing CPAP machines for patients, while several sporting goods businesses are making personal protective equipment for health care workers.
Rare World War II Footage Is Released by Bletchley Park, British Spy Center	An 11-minute silent film shows MI6 staff members at a site linked to the code-breaking facility Bletchley Park during World War II.
How to Edit Your Own Writing	Writing is hard, but donâ€™t overlook the difficulty â€” and the importance â€” of editing your own work before letting others see it. Hereâ€™s how.
Domestic Abusers Can Control Your Devices. Hereâ€™s How to Fight Back.	Hereâ€™s how to record abuse without being discovered, safeguard your devices, and, ultimately, protect yourself.
How to Put Your Pantry in Order (and Stop Wasting Food)	Step one: Start by making a mess. Hereâ€™s what to do after that.
Why Talking About Our Problems Helps So Much (and How to Do It)	Thereâ€™s more to the age-old advice to just â€œtalk it outâ€ than there seems. Hereâ€™s some of the evidence that explains why it is so helpful.
Fear of Rejection Is Costing You Money	And what to do if you want to see long-term financial gains.
In Korea, Watching â€˜Tiger Kingâ€™ and Training for Baseball Alone	Foreign players in the Korean Baseball Organization who went home during the peak of South Koreaâ€™s outbreak are self-isolating as the league aims to resume exhibitions later this month.
A Reader Looking for Remedies Thinks Back to Other Difficult Times	The current crisis is hard for readers even though, for many, it has come with the unexpected gift of free time and nowhere to be.
Idelle Weber, Who Stretched the Meaning of Pop Art, Dies at 88	One of the few women involved in the Pop Art movement, she captured the anonymity of corporate life in silhouettes. She later turned to realism.
Tiny Love Stories: â€˜The Dumbest Fight Iâ€™ve Ever Been Inâ€™	Modern Love in miniature, featuring reader-submitted stories of no more than 100 words.
We Can Still Travel â€” With Photoshop and a Dream	Thereâ€™s little choice now but to stay grounded because of the coronavirus, but avid travelers are devising creative and meaningful ways to celebrate the vacations they have had to cancel.
Howâ€™s the View From a Spinning Star?	Stargazing is fun. Now try it at 43,000 miles per second.
To Study a Problem Thatâ€™s Everywhere, Theyâ€™re Getting Creative	Dimitri Deheynâ€™s lab has become a hub of novel research on the microfibers found in our waterways and even the air we breathe.
Where Have All the Heart Attacks Gone?	Except for treating Covid-19, many hospitals seem to be eerily quiet.
Meet the Xenobots, Virtual Creatures Brought to Life	Computer scientists and biologists have teamed up to make a new class of living robotics that challenge the boundary between digital and biological.
How to Look Good on Camera, According to Tom Ford	A master class in lighting for your next video conference.
Try Tiles	Our soothing matching game may help you de-stress.
The Crossword, Vertex and More	Solve the daily puzzle edited by Will Shortz, or try out other games like the Mini and Letter Boxed.
Try Spelling Bee	Puzzle throughout the day to see how many words you can find.
